14 18
####*************%
#F^*D             
#####  *         #
###    *         #
###    *         #
###    *         #
###    *         #
#      ********** 
#F    #*        $#
#######D##########
$        #        
###    * #       #
#*    #*    ^    F
##################