15 34
##################################
#         #    ^                 #
#    ^    #                      #
#         #                      #
#         #                      #
### #######                      #
#                                 
#  ******************$          $*
#        #########################
#$       #                       #
#        #             ###### ####
#        #             #$        #
#        #                 ^     #
#$****** *     %       #         #
##################################